25 25 25 25 25 25 25 25 25 25 25 25 25 25 25 25 25 25 25 25 25 25 25 25 25 25 25 25 25 25 25 25 25 25 25 25 25 25 25 25 25 25 25 25 25 25 25 25 25 25
25 25 25 25 25 25 25 25 25 25 25 25 25 25 25 25 25 25 25 25 25 25 25 25 25 25 25 25 25 25 25 25 25 25 25 25 25 25 25 25 25 25 25 25 25 25 25 25 25 25
25 25 10 10 10 10 10 25 25 25 25 25 25 10 10 10 10 10 10 10 10 10 10 10 10 10 10 10 10 10 10 10 10 10 10 10 10 10 12 12 12 12 12 25 25 25 25 25 25 25
25 25 10 10 10 10 10 25 10 10 10 25 25 10 10 22 22 22 22 10 10 22 22 22 22 10 10 25 25 25 25 25 25 25 25 25 25 25 12 12 11 12 12 25 25 25 25 25 25 25
25 25 10 10 10 10 10 10 10 10 10 25 25 10 10 22 24 24 22 10 10 22 24 24 22 10 10 25 25 25 25 25 25 25 25 25 25 25 12 11 10 11 12 25 25 25 25 25 25 25
25 25 10 10 10 10 10 10 10 10 10 25 25 10 10 22 24 24 22 10 10 22 24 24 22 10 10 25 25 25 25 25 25 25 25 25 25 25 12 12 11 11 12 25 25 25 25 25 25 25
25 25 10 10 10 10 10 25 10 25 25 25 25 10 10 22 26 22 22 10 10 22 22 26 22 10 10 10 25 25 25 25 25 25 25 25 25 25 12 12 12 12 12 25 25 25 25 25 25 25
25 25 25 10 10 10 25 25 10 25 25 25 25 10 10 12 10 12 10 10 10 12 12 10 10 10 10 10 25 25 25 25 25 25 25 25 25 25 25 25 25 25 25 25 25 25 25 25 25 25
25 25 25 10 10 25 25 25 10 25 25 25 25 10 10 10 10 10 10 10 10 10 10 10 10 10 10 25 25 25 25 25 25 25 25 25 25 25 25 25 25 25 25 25 25 25 25 25 25 25
25 25 25 10 10 25 25 25 10 25 25 25 25 25 25 25 25 25 25 10 10 25 25 25 25 25 25 25 25 25 25 25 25 25 25 25 25 25 25 25 25 25 25 25 25 25 25 25 25 25
25 25 25 10 10 10 10 10 10 25 25 25 25 25 25 25 25 25 25 10 10 25 25 25 25 25 25 25 25 25 25 10 10 10 10 10 10 10 10 10 10 10 10 10 10 10 10 25 25 25
25 25 25 10 10 10 10 10 10 25 25 25 25 25 25 25 25 25 25 10 10 25 25 25 25 25 25 25 25 25 25 10 10 10 10 10 10 10 10 10 10 10 10 10 10 10 10 25 25 25
25 25 25 10 10 25 25 25 25 25 25 25 25 25 25 25 25 25 25 10 10 25 25 25 25 25 25 25 25 10 10 10 10 25 25 25 25 10 10 10 10 10 10 10 10 10 10 25 25 25
25 25 25 10 10 25 25 25 25 25 25 25 25 25 25 25 25 25 25 10 10 25 25 25 25 25 25 25 25 10 10 10 10 25 25 25 25 10 10 10 10 10 10 10 10 10 10 25 25 25
25 25 25 10 10 25 25 25 25 25 25 25 25 25 25 25 25 25 10 10 10 10 25 25 25 25 25 25 25 10 10 25 25 25 25 25 25 10 10 10 10 10 10 10 10 10 10 25 25 25
25 25 25 10 10 25 25 25 25 25 25 25 25 25 25 25 25 10 10 10 10 10 10 25 25 25 25 25 25 10 10 25 25 25 25 25 25 10 10 10 10 10 10 10 10 10 10 25 25 25
25 25 25 10 10 25 25 25 25 25 25 25 25 25 25 25 10 10 10 10 10 10 10 10 25 25 25 25 25 10 10 25 25 25 25 25 25 10 10 10 10 10 10 10 10 10 10 25 25 25
25 25 25 10 10 25 25 25 25 25 25 25 25 25 25 10 10 10 10 10 10 10 10 10 10 25 25 25 25 10 10 25 25 25 25 25 25 10 10 10 10 10 10 10 10 10 10 25 25 25
25 25 25 10 10 10 10 10 10 10 10 10 10 10 10 10 10 10 10 10 10 10 10 10 10 10 10 10 10 10 10 25 25 25 25 25 25 10 10 10 10 10 10 10 10 10 10 25 25 25
25 25 25 10 10 10 10 10 10 10 10 10 10 10 10 10 10 10 10 10 10 10 10 10 10 10 10 10 10 10 10 25 25 25 25 25 25 10 10 10 10 10 10 10 10 10 10 25 25 25
25 10 10 25 10 25 25 25 25 25 25 25 25 25 25 10 10 10 10 10 10 10 10 10 10 25 25 25 25 25 25 25 25 25 25 25 25 10 10 10 10 10 10 10 10 10 10 25 25 25
25 10 10 10 10 25 25 25 25 25 25 25 25 25 25 25 10 10 10 10 10 10 10 10 25 25 25 25 25 25 25 25 25 25 25 25 25 10 10 10 10 10 10 10 10 10 10 25 25 25
25 10 10 10 10 25 25 25 25 25 25 25 25 25 25 25 25 10 10 10 10 10 10 25 25 25 25 25 25 25 25 25 25 25 25 25 25 10 10 10 10 10 10 10 10 10 10 25 25 25
25 10 10 25 25 25 25 25 25 25 25 25 25 25 25 25 25 25 10 10 10 10 10 25 25 25 25 25 25 25 25 25 25 25 25 25 25 10 10 10 10 10 10 10 10 10 10 25 25 25
25 25 25 25 25 25 25 25 25 25 25 25 25 25 25 25 25 25 25 10 10 25 10 25 25 25 25 25 25 25 25 25 25 25 25 25 25 10 10 10 10 10 10 10 10 10 10 25 25 25
25 25 25 25 25 25 25 25 25 25 25 25 25 25 25 25 25 25 25 10 10 25 10 25 25 25 25 25 25 25 25 25 25 25 25 25 25 10 10 10 10 10 10 10 10 10 10 25 25 25
25 25 25 25 25 25 25 25 25 25 25 25 25 25 25 25 25 25 25 10 10 25 25 25 25 25 25 25 25 25 25 25 25 25 25 25 25 25 25 25 25 25 25 25 25 25 25 25 25 25
25 25 25 25 25 25 25 25 25 25 25 25 25 25 25 25 25 25 25 10 10 25 25 25 25 25 25 25 25 25 25 25 25 25 25 25 25 25 25 25 25 25 25 25 25 25 25 25 25 25
25 25 25 25 25 25 25 25 25 25 25 25 25 25 25 25 25 25 25 10 10 25 25 25 25 25 25 25 25 25 25 25 25 25 25 25 25 25 25 25 25 25 25 25 25 25 25 25 25 25
25 25 25 25 25 25 25 25 25 25 25 25 25 25 25 25 25 25 25 10 10 25 25 25 25 25 25 25 25 25 25 25 25 25 25 25 25 25 25 25 25 25 25 25 25 25 25 25 25 25
25 25 25 25 25 25 25 25 25 25 25 25 25 25 25 25 25 25 25 10 10 25 25 25 25 25 25 25 25 25 25 25 25 25 25 25 25 25 25 25 25 25 25 25 25 25 25 25 25 25
25 25 25 25 25 25 25 25 25 25 25 25 25 25 25 25 25 25 25 10 10 25 25 25 25 25 25 25 25 25 25 25 25 25 25 25 25 25 25 25 25 25 25 25 25 25 25 25 25 25
25 25 25 25 25 25 25 25 25 25 25 25 25 25 25 25 25 25 25 10 10 25 25 25 25 25 25 25 25 25 25 25 25 25 25 25 25 25 25 25 25 25 25 25 25 25 25 25 25 25
25 25 25 25 25 25 25 25 25 25 25 25 25 25 25 25 25 25 25 10 10 10 10 10 10 10 10 10 10 10 10 10 10 10 10 10 25 25 25 25 25 25 25 25 25 25 25 25 25 25
25 25 25 25 25 25 25 10 10 10 10 10 10 10 10 10 10 10 10 10 10 10 10 10 10 10 10 10 10 10 10 10 10 10 10 10 25 25 25 25 25 25 25 25 25 25 25 25 25 25
25 25 25 25 25 25 25 10 14 15 15 15 15 15 15 15 15 15 15 15 15 15 15 15 15 15 15 16 10 10 14 15 15 15 16 10 25 25 25 25 25 25 25 25 25 25 25 25 25 25
25 25 25 25 25 25 25 10 21 13 13 13 13 13 13 13 13 13 13 13 13 13 13 13 13 13 13 17 10 10 21 13 13 13 17 10 25 25 25 25 25 25 25 25 25 25 25 25 25 25
25 25 25 25 25 25 25 10 21 13 13 13 13 13 13 13 13 13 13 13 13 13 13 13 13 13 13 17 10 10 21 13 13 13 17 10 25 25 25 25 25 25 25 25 25 25 25 25 25 25
25 25 25 25 25 25 25 10 21 13 13 13 13 13 13 13 13 13 13 13 13 13 19 19 19 19 19 18 10 10 21 13 13 13 17 10 25 25 25 25 25 25 25 25 25 25 25 25 25 25
25 25 25 25 25 25 25 10 21 13 19 19 19 19 13 13 13 13 13 13 13 17 10 10 10 10 10 10 10 10 21 13 13 13 17 10 25 25 25 25 25 25 25 25 25 25 25 25 25 25
25 25 25 25 25 25 25 10 21 17 22 22 22 22 21 13 13 13 13 13 13 17 10 10 10 10 10 10 10 10 21 13 13 13 17 10 25 25 25 25 25 25 25 25 25 25 25 25 25 25
25 10 10 10 25 25 25 10 21 17 22 24 24 22 21 13 13 13 19 19 19 18 10 10 10 10 10 10 10 10 21 13 13 13 17 10 25 25 25 25 25 25 25 25 25 25 25 25 25 25
25 10 10 10 25 25 25 10 21 17 22 24 24 22 21 13 13 17 10 10 10 10 10 10 10 10 10 10 10 10 21 13 13 13 17 10 25 25 25 25 25 25 25 25 25 25 25 25 25 25
25 10 10 10 25 25 25 10 21 17 22 24 24 22 21 13 13 17 10 14 15 16 10 10 10 10 10 14 15 15 13 13 13 13 17 10 25 25 25 25 25 25 25 25 25 25 25 25 25 25
25 10 10 10 25 25 25 10 21 17 22 22 24 22 21 13 13 17 10 21 13 13 15 15 15 15 15 13 13 13 13 13 13 13 17 10 25 25 25 25 25 25 25 25 25 25 25 25 25 25
25 10 10 10 10 10 10 10 21 13 16 25 10 25 20 19 19 18 10 21 13 13 13 13 13 13 13 13 13 13 13 13 13 13 17 10 25 25 25 25 25 25 25 25 25 25 25 25 25 25
25 10 10 10 10 10 10 10 21 13 13 16 10 10 10 10 10 10 10 21 13 13 13 13 13 13 13 13 13 13 13 13 13 13 17 10 10 10 10 10 10 10 12 25 25 25 25 25 25 25
25 25 25 25 25 25 25 10 21 13 13 13 15 15 15 15 15 15 15 13 13 13 13 13 13 13 13 13 13 13 13 13 13 13 17 10 25 25 25 25 25 25 25 25 25 25 25 25 25 25
25 25 25 25 25 25 25 25 20 19 19 19 19 19 19 19 19 19 19 19 19 19 19 19 19 19 19 19 19 19 19 19 19 19 18 25 25 25 25 25 25 25 25 25 25 25 25 25 25 25
25 25 25 25 25 25 25 25 25 25 25 25 25 25 25 25 25 25 25 25 25 25 25 25 25 25 25 25 25 25 25 25 25 25 25 25 25 25 25 25 25 25 25 25 25 25 25 25 25 25
